#######
#  P  #
#     #
#  N  #
#######

